TILES
Tileset0.png
MAP
8 8
0 3 6 9 12 15 18 -1
1 4 7 10 13 16 19 -1
2 5 8 11 14 17 20 -1
0 3 6 9 12 15 18 -1
1 4 7 10 13 16 19 -1
2 5 8 11 14 17 20 -1
0 3 6 9 12 15 18 -1
1 4 7 10 13 16 19 -1
